1 1 1 1 1 1 1 1 1 1
1 1 1 1 1 1 1 1 1 1
1 1 1 1 1 1 1 1 1 1
0 0 0 0 0 0 0 0 0 0
0 1 1 0 1 1 0 1 1 0
0 1 1 0 0 0 0 0 0 0
0 1 1 0 1 1 1 1 1 0
0 1 1 0 1 4 0 1 1 0
0 1 1 0 1 4 0 1 1 0
0 0 0 0 2 6 4 4 4 5