1 0 0 0 1 0 0 0 1 1
1 0 1 0 1 0 1 0 1 1
1 0 1 0 0 0 1 0 1 1
0 0 1 4 1 1 1 0 0 0
0 1 1 4 1 1 4 1 1 0
0 1 4 4 4 4 2 0 0 0
0 1 3 1 1 1 4 1 1 1
0 1 3 1 5 4 4 1 0 1
0 1 6 1 1 1 0 1 0 1
0 0 0 1 1 1 0 0 0 1