1 1 0 6 1 0 0 0 1 1
1 1 0 1 1 0 1 0 1 1
1 1 0 0 0 0 1 0 1 1
1 1 1 4 1 1 1 0 0 0
1 1 1 4 1 1 4 1 1 0
1 1 1 4 4 4 2 4 0 0
1 1 1 1 1 1 4 1 1 1
1 1 1 1 1 1 3 1 5 1
1 1 1 1 1 1 3 1 3 1
1 1 1 1 1 1 3 3 3 1
